Address,Total Stake,Owner Stake,Delegators Stake,Free Space,Delegators,Uptime,Fee
8qSyua2WVQ4uNRc1wwPKmSUWY421bifiq,199924191,30000000,169924191,75809,372,100.00%,10.00
MfzBQ6MbriE31UWm9NjSnEgLiR1cAkEnN,199845081,29990100,169854981,154919,332,99.99%,10.00
A7jk7Z5GA2aVe5ecuupNXWtSLfVjLDWFC,199915169,30000000,169915169,84831,265,99.98%,7.50
2hCHs6H4Vde8mdGGKidMvT4Fjit7goCBT,44999866,3000000,41999866,134,206,98.39%,2.00
Cg8PLmdZ9JmEtUBCZhq2jt2JDS5gDaSsQ,59936494,4000000,55936494,63506,203,99.97%,5.00
EgJba99Q5iDcL81A27E111WANn9eZNj4v,47092245,3500000,43592245,5407755,193,100.00%,20.00
HZwFckGTbucqTtE7qcv6z85mnScUfAeW6,149929129,10000000,139929129,70871,160,100.00%,15.00
NzPsG7kxDpS49cqWhvwaNXbJYPvVgTu6N,41683335,4000000,37683335,18316665,143,100.00%,20.00
FHPDnySFVqde5bGvEXsFnvZGhXwcyRfNY,130302300,15000000,115302300,69697700,142,97.02%,10.00
P4T4uKqveVxjZZXVdADHENdnCKnsCFvDE,43773347,3000000,40773347,1226653,116,100.00%,10.00
6cnsMcUNTJwCcDuAyPwJqEaVa6yMrk8eq,180453735,13333334,167120401,19546265,109,99.83%,17.50
7joNh7X4xsHBSXCpLQig22nSqU6xp41k8,101792107,6879915,94912192,1406618,109,99.96%,10.00
MsF6Xc1PsMWtcxVudCepWb5kUeF1EF8RX,106858058,8500000,98358058,20641942,100,100.00%,17.50
D3QKd6XxLnrKowkziZJSG4RNLtffz8ESk,52401046,3500000,48901046,98954,93,100.00%,19.00
3RJrjDMzeZQVDyHDjZ6u1X3Y3WCKY5nbb,77406263,13500000,63906263,122593737,87,100.00%,17.50
2xbUrUGcj9HuntjA4YPHQFWiMuQz428SL,18721171,1250000,17471171,28829,87,100.00%,20.00
Gy2c6Y1RNz2PZfAnTwHZMZ4RZ53nKPf1Q,55694719,30000000,25694719,144305281,85,100.00%,20.00
xi5DWBUKqBJUWvHiDEr9hpVNLGbxRtu2,76405672,30000000,46405672,123594328,84,99.99%,10.00
F297gLgRxBndijAYvvvBGtQTwYCrScMQT,52686939,4250000,48436939,11063061,79,100.00%,20.00
Bo98cjoi5LvF6jXAMHZZLQYutyeGutBQ1,103954426,7000000,96954426,1045574,78,100.00%,15.00
J9JZSkVJWCUYZ43n36q4fCixu7Tj4QR1P,32728151,2250000,30478151,1021849,78,100.00%,20.00
2q436GJKA5faTceNaAbu7CYxftv3K8fS4,61693483,6750000,54943483,39556517,78,99.88%,15.00
5V2bQbryZTU4pAe59KNHNBru1BwEfcXqg,76594678,13333334,63261344,123405322,77,99.98%,15.00
2a7BPY7UeJv2njMuyUHfBSTeQCYZj6bwV,110189714,7500000,102689714,2310286,76,99.99%,10.00
JZuVSDnBui1u82RmkbkWKJ1JxfdxuVYR9,77677959,30000000,47677959,122322041,76,99.98%,15.00
EJ7V3trSnp93txcLP3h4ULJvBhvUtP66c,58319898,10000000,48319898,91680102,73,99.93%,18.00
3phxSiKoYMj1dNSJysZhHYQKUbLX786jy,93894837,7700000,86194837,21605163,71,100.00%,20.00
FXJQRCN2nEqBYVsorBS5WHriwihjzv7G6,113054885,11000000,102054885,51945115,61,100.00%,15.00
B9o4BTqdc1qkrAn5BxLHL7pimWf9UwBkd,65639689,4500000,61139689,1860311,60,100.00%,13.00
EqTrzH8b9ax2oYwrKFkXqWAZjuK8uHFxS,40115876,3000000,37115876,4884124,58,99.99%,20.00
4hyFQEeDqpG9yyEnafTwqQQTTFex32KG2,34340207,6750000,27590207,66909793,58,99.99%,18.00
98RaC6gbJMhin1NXsBFUoicEqiF7VKWbL,38689173,4500000,34189173,28810827,48,100.00%,20.00
JFiAG1SiqUFh3EnkY8oXcXUg8RuT2guZp,43149133,3000000,40149133,1850867,45,100.00%,10.00
NCBqn9P8oAEkYn6McyQjhF67WarSTttz5,35687972,2500000,33187972,1812028,43,100.00%,15.00
J4nyqo44xFUxhAi9gDJXAkYyxP5z2a7UG,22244802,2056380,20188422,8600898,41,99.99%,20.00
9jaZDNBCn4AwMzRqFBhxfem2ZZtiArRm2,44024682,3250000,40774682,4725318,37,74.38%,10.00
CrsvTSFLB8G3ziPaVjgH1pj8NQxSZkECD,33749999,2250000,31499999,1,36,100.00%,14.50
LcbbZYhBHn8HVjTzPASuHtFVAckcdctWS,37139198,5000000,32139198,37860802,36,99.99%,20.00
5JkXthgpWVDq6utrtV1YVG7aspsHjhezM,200000000,15000000,185000000,0,35,99.99%,10.00
66rV9yEWSVGLC8fs9ynKptVf9f6bSbHC8,104626858,7000000,97626858,373142,30,99.99%,10.00
3v6zserYt9MD58FCmsPo2Qto5AwYAkm6s,39361541,30000009,9361532,160638459,30NO REWARDS,89.17%,10.00
JF4XWnC9PjZVXQuqLcpQvxztdMez3CpkR,31761440,3000000,28761440,13238560,30,96.48%,18.00
5jV2rg4CGt6ewiDbB9QeWDEptVudskJeY,25877094,2000000,23877094,4122906,29,100.00%,15.00
KtTdea6FeDDy5pERrZKHkkhtJFCbJNv1a,28754116,3000000,25754116,16245884,29,100.00%,20.00
DcUJTi6u5Xoutgr1A25iMu4Rp5JEbsEqr,27727491,3800000,23927491,29272509,27,99.99%,15.00
LxpVHRQAYXPRf7q5oz1iT4N1z9XHz5rHU,181675850,29999900,151675950,18324150,27,99.99%,10.00
MWNqxgXd8itY143jaNyq8aMYTeV1RXJgS,106626329,29900091,76726238,93373671,26,99.99%,10.00
3qpQ3cVcU8UxvmCtkwGV4ZB3RYcKoDBRn,139110404,9500000,129610404,3389596,25,100.00%,10.00
DAVrAR2VCxe7rnmkDaVUbW8jWd9b86cS,157423107,10500000,146923107,76893,25,100.00%,12.00
4zWvBNmsbaS9UKQf6wcWgWGWRfitcGAuV,49943090,14999995,34943095,150056910,25,100.00%,10.00
ECqqsWu9jpUvZgPyf9yPZZcyWmJjWyN1T,198864397,13500000,185364397,1135603,24,98.83%,20.00
4h6PNpK5oo9pjmE8zKSbm31S2LStg4tyF,13019530,1000000,12019530,1980470,20,98.84%,20.00
7niiMEHRfGLgT6VZ7bwb6Xa6vpGn8upVw,107028982,7250000,99778982,1721018,20,100.00%,10.00
CtSfUZd8nvr4RDaQnKRiP9cae15Nrb1bX,53669200,3601200,50068000,348800,19,100.00%,12.50
MzMscku8ayAd2pBEmH8xWiAXBwtPgS2S5,53456336,8000000,45456336,66543664,19,100.00%,15.00
GGnTyHtMF7b8CELtUgFGTEHjEcjNF7RZ,26092705,3000000,23092705,18907295,19,100.00%,20.00
Nwi6MgscyMFQciLyabSFWpWHBQATBVGfk,18334181,1750000,16584181,7915819,18,99.52%,20.00
9Y4mWN6L4MPLA2tvAwMXDJXeAJYfD5Try,13521951,1000000,12521951,1478049,18,100.00%,14.00
G5kkF5H1AGaY3n9h9PCXdiFqjyP1jYhJW,27787472,11377673,16409799,142877623,17,100.00%,19.50
N3GDYNsVNMxYTW4ULzrfRZpy3tRnhxKSQ,199899861,20000000,179899861,100139,17,100.00%,10.00
K9g6YJEhWiN2TF1RsFTA8SEXFAJWvikhu,101377419,10000000,91377419,48622581,17,100.00%,15.00
KB4zWTTeK5gHYKYmjftGGQ8nHy9NQbGax,21754617,15000000,6754617,178245383,17,89.97%,15.00
4e5tHaeoLvpXjtY5uMXtuYJgEWZ2JiC4D,32550795,2250000,30300795,1199205,16,100.00%,12.00
Ckyh9cpfkkXSo5PYNNFactcrKkY2XhkXR,13880843,1250000,12630843,4869157,16,100.00%,20.00
EPLACd344ouymyJAQYXZBvbmU3NJ6ooeB,119080901,7959594,111121307,313009,15,100.00%,15.00
CoNH4gyEwB9gTrEmozwh14Zr8hs6wokRS,28026991,10000000,18026991,121973009,14,100.00%,20.00
FDR3CXdwP3H3Zz9QKfL61fk56zkPEgdFV,105225148,7592160,97632988,8657252,14,100.00%,15.00
9WF8MvjNhmR45AdNjVfAWp27KKq7KCGpm,25086606,3130007,21956599,21863494,14,97.52%,20.00
P6nNyHc4QwyKoVSS7c9XatGp4Sityq7rM,20153086,3500000,16653086,32346914,14,99.99%,20.00
NV7ZpcJvqzmvvT4PaeHWbTELWKFT2Jqxw,4460525,1560700,2899825,18949975,14,100.00%,20.00
KH2o8xGFLYtCwseWgRbpDAf1n4zAcMNfN,16519737,10000000,6519737,133480263,14,100.00%,15.00
7HLcuEFt7c1qTggK8AkLim9ekhPu2NYLM,57716635,30000000,27716635,142283365,13NO REWARDS,99.90%,10.00
MN7sJduRdGUs3aWyYUmym2CFVsptzgKcJ,161969831,11000000,150969831,3030169,13,100.00%,18.00
J8Zbi3b3AjTEUmHdE4KSApEU1U36iaeDS,27579679,8000000,19579679,92420321,12,100.00%,18.00
JA63moobNNMLby4ENNUiJqVJA2cdpks5J,35646701,2751551,32895150,5626561,11,100.00%,14.00
Q9KeAQKSyxtJj8mfum951Q5akkoFBJLTs,33675091,30000000,3675091,166324909,11,99.95%,20.00
7vz3A92AkLi9YRYTauPgvkdiMmhnuDRzj,57932588,4000000,53932588,2067412,9,97.85%,20.00
C3FRhsMBh3KNLKiVbc8xLY7gnVzmJ7EY9,19251995,3000000,16251995,25748005,9,99.92%,20.00
JHnfNSNgSThSJEFG8aq99FRAE4a7Ko7UP,21607771,4000000,17607771,38392229,6,100.00%,20.00
KzPd2Vx5WomGtur91B9K9R7to3mYyYga,18350000,3000000,15350000,26650000,6,100.00%,18.00
k4QG8eJ9bYu717nbj8Ki8VykK8g1VWK9,18660658,3000000,15660658,26339342,6,100.00%,20.00
FERvNWfCH4mjCSoFnjF4YouDBuYZCpfKm,18585496,3250000,15335496,30164504,5,100.00%,15.00
CeX1NfNPHCdaJXUVtkLysShaZCtsHRK3D,13604630,2172490,11432140,18982720,5NO REWARDS,97.05%,20.00
FUA8LX6gJhNmiJVT5eycNsd2jKBHL7FBY,33446860,32747171,699689,166553140,5NO REWARDS,100.00%,100.00
Q3WJQcoixGGKnFs41B18rnJB9PS54M5oF,143204783,10000000,133204783,6795217,5,96.09%,15.00
GPBkpSGC7YpRbd1TsNZk84C2TQfNja6FQ,21034993,3000000,18034993,23965007,4,64.16%,20.00
FLPF99Gi1c79NGHw7GYyhttWPVxpCq713,18265883,3000000,15265883,26734117,3,99.43%,12.50
B6sAUBEYn2fvHMeUnsUkh1yNrvTzKu8gZ,5770000,4000000,1770000,54230000,3,100.00%,20.00
KRkND3cB1bYaWt71CSQdCUjRSR95d3cNz,5275312,5000000,275312,69724688,2,100.00%,20.00
LKS1hi95iVbqGDyU1vbkyPLd4wknJfqF9,1686677,1216120,470557,16555123,2,99.98%,20.00
9vmnHcK2XCBDf7uNfkq6CqRGpE6FJsN5K,18000000,3000000,15000000,27000000,1NO REWARDS,100.00%,18.00
KppZbRMtfNTQZGdmHdkbHTJHgNPBCNxJj,1350000,1300000,50000,18150000,1,68.03%,22.00
NbTToANYcdsreLC5PBcE9gsMBpBY7N7s1,4018314,3750000,268314,52231686,1,100.00%,20.00
5BWT2P6E2kjKWsVDVzsj2XwtuxiwV7oAq,1000050,1000050,0,14000700,0,100.00%,20.00
